KEYCODES:
 =VOID
F=FIRE
W=WATER
M=METAL
S=EARTH
G=EARTH
T=TREE
L=TREE

SPRITES:
S=./MAP/SPRITES/stone1.png
G=./MAP/SPRITES/ground1.png
T=./MAP/SPRITES/wood1.png
L=./MAP/SPRITES/leaves1.png
 =./MAP/SPRITES/void.png

MAP:
width=20
height=15
content=[S][S][S][S][S][S][S][S][S][S][S][S][S][S][S][S][S][S][S][S]\
[S][ ][ ][ ][ ][ ][ ][ ][ ][ ][ ][ ][ ][ ][ ][ ][ ][ ][ ][ ]\
[S][ ][ ][S][S][S][ ][ ][ ][ ][ ][ ][ ][ ][ ][ ][L][ ][ ][ ]\
[S][ ][ ][ ][S][S][ ][ ][ ][ ][ ][ ][ ][ ][ ][L][L][L][ ][ ]\
[S][ ][ ][ ][ ][S][S][ ][ ][S][ ][ ][ ][ ][ ][ ][L][L][ ][ ]\
[S][ ][ ][ ][ ][ ][S][ ][ ][S][ ][ ][ ][ ][ ][ ][T][ ][ ][ ]\
[S][ ][ ][ ][ ][ ][S][ ][ ][S][ ][ ][ ][ ][ ][ ][ ][ ][ ][ ]\
[S][ ][ ][ ][ ][ ][S][S][S][S][ ][ ][ ][ ][ ][ ][T][ ][ ][ ]\
[S][ ][ ][ ][ ][ ][ ][ ][ ][ ][ ][ ][ ][ ][ ][ ][T][ ][ ][ ]\
[G][ ][ ][ ][ ][ ][G][G][G][G][ ][ ][ ][G][G][G][G][G][G][G]\
[S][S][ ][ ][ ][ ][S][S][S][S][ ][ ][ ][S][S][S][S][S][S][S]\
[S][ ][ ][ ][ ][ ][ ][ ][ ][ ][ ][ ][ ][ ][ ][ ][L][ ][ ][ ]\
[S][ ][ ][ ][ ][ ][ ][ ][ ][ ][ ][ ][ ][ ][ ][L][L][L][ ][ ]\
[S][ ][ ][ ][ ][ ][ ][ ][ ][ ][ ][ ][ ][ ][ ][L][L][L][ ][ ]\
[G][G][G][G][G][G][G][G][G][G][G][G][G][G][G][G][G][G][G][G]
